###                 #########
#   ###################   # #
# ####G               # # # #
# ################### # # # #
#                     # # # #
##################### # # # #
#   ##                # # # #
# # ## ### ## ######### # # #
# #    #   ## #         # # #
# # ## ################ # # #
### ##             #### # # #
### ############## ## # # # #
###             ##    # # # #
###### ######## ####### # # #
###### ####             #   #
S      ######################
