################################################
#S# #            #                            G#
# # # ########## # #############################
# # #          # # #             #             #
# # ############ # # ########### # ########### #
# #              # # #         # #           # #
# ############## # # # ####### # ########## # #
#             # # # # #       #             # #
############# # # # # # ##################### #
#             # # # # #                       #
# ########### # # # ######################### #
#           # # # # #                       # #
########### # # # # ####################### # #
#         # # # # # #                     # # #
# ####### # # # # # ##################### # # #
#       # # # # # #                     # # # #
####### # # # # # ##################### # # # #
#       # # # # # #                   # # #   #
################################################